Patrick,Rasmus,Bjørn,Magnus,Kjetil,Mariusz,Petter,Sondre
Tyranids,CWE,DG,Tau,Necrons,Sisters,GSC,Drukhari
5,3,3,5,0,0,0,3
3,2,4,3,3,3,3,3
4,4,2,4,3,4,2,3
1,0,0,5,0,3,2,0
1,1,1,3,0,3,0,1
3,0,4,5,4,3,1,2
1,2,1,4,1,3,0,2
5,3,0,5,3,3,0,2